#####U#####
#         #
#         #
#         #
#  E   E  #
#         #
#  E   E  #
#         #
#         #
#         #
#####D#####
