#####U#####
#         #
#      E  #
#         #
#         #
#         R
#  E      #
#         #
#  E   E  #
#         #
###########