#####U#####
#         #
# E       #
#         #
# E       #
#         R
# E       #
#         #
# E       #
#         #
#####D#####
