#####U#####
#         #
#       E #
#         #
#       E #
L         #
#       E #
#         #
#       E #
#         #
#####D#####
