#####U#####
#         #
#         #
#         #
#         #
L         R
#         #
#         #
#         #
#         #
#####D#####
