#U####U######
#           #
#           #
#           #
#   E   E   #
#           R
#           #
#   E   E   #
#           #
L         # #
#           #
######D######
